1111111111111111111111111111111111111111111111111111111111111111111111111111111111111111111111111111
1000000000000100100010000001000000010000000000100110000100010000010100000000010000001000010010000001
1000000100000000001010010110000000001000000000100110010110000100000000100001000001001000000000110001
1000001000000000010000000100000010100100100000100001110010000101000001000000111000010000000000000001
1000000000000010000010000100000001001000010010001000000000001000001000100000100101000000010001010001
1010000011000010000010001000000001010100000001010010001010000010000100100010000000000000100010000001
1000000000000100010000000001010100000000010010000100000000000101010000100110000010000100000000000001
1010000100000010100001101000010000110010100100000011011000000010000100010011000000010000001000000001
1001001000000000000001000000010000010000100000000000000001101010000000100001010000000001001000000001
1000010010111000010100110100000011011100000100000000100001001000000000000100010100000000100111000001
1000001000000001000000100010000000010010101000000010000000010000001001001000000100010000010100000111
1010000001100101101000000000000000000100000000000000000000010000000010101100010001001100010000001111
1001000010100000000101000000000001010100000000000000000000001000001100010000011100000000010000001101
1000000000000001100000000000010001100100000011000000001000000100100000010000000000011100000100100001
1010000001000001100001011000010100010001001000000001001001000000000000000000000000110000001110000101
1000000000010000100000000010000011001010000000001110100000000110000001000010001001100100000000000001
1001000010000000001001000010001000011000110001000000100000010000001000000010000000010000000000100101
1000010000101001001001010000100010000100100100000001000001010000000000000001001000000000000000010111
1011100000001000011000010010010000000100000000110100100001100000000000000110100000110101110010000101
1100001001001000100010100000110000000000000001001000000100000010100000000011101000000001000010000001
1000001010000000010000000010101000101010000010100110100000000000100000010110000000000000010000000001
1011110010000000000001000001111000000001000000001000001000010100000000000001000011000000001000000011
1000001100000010001101001110000010100101000100010010010000010000010000100001000100011100011000000101
1101000001001000010000000011000100010000000010001010000000000001000000000100000010000101000000111001
1010011100100000000000000000100000011000000001000000001100000000000000010001000010000010000110001001
1001100000101000000010000000001000001000000100001000100000000000100000000001010100001100101000000011
1000000000000010110100000000000000100000100000000000001000000000010000000010000000000000000000100001
1001100110000100000010000000000001010010000000000000000101100000000010000000000000010000000000000101
1010010000000011000010001000000000000000000100000110110100100000010001000000000000000100100010100001
1000001000000000110100000000100010000000000010100100000000000000010001000011000000011000000000000111
1000100000000001000010000100000101000010000110101001000000000101110000010110100100000000010101011101
1000000000000000001010000000010001001000110010010000000000000010001000001000000101000000000000001001
1001100000000000100010001010000010000000000001000100000000100100000011000011000000100000000001110001
1000000010010101010000000000010101000011000000010001100010100000011000000000010000000000001000000001
1000011001010000000000001000000001110001001001000000000000000010001000000000010000000100001111000001
1000000000100000000000000010101000000000000000010001000000000000000000100000000100010110010001100011
1000101001010000001001100100000110010000011000100000010000000000000010000010010000000001000000010011
1011000010100000001001000101000000100000100100100110000100000000001000010010000011100000000110000001
1100011000000000000000000000100100010001010001000011001010000100000000000000001000100110100000100001
1010001001000001100100001100000000001000100000000100001000011100010010001010001001000000000000000011
1010010000100100000000000000010000011000000001010001001101000000010000011100100110100000000001000001
1001100010001110000010000000001000000001000001100000000110000000011000100101000011001100010001100101
1101100000100000000000000000000000110100001001000000010000000000000100000000000100000100100000000011
1000100001000001000000110011010000001000000000000010010000000000000000000110000000001101000000000001
1100000000100000000001001010001100000000000100000000000000000000000000101000110001100000001000010001
1001000000000000100100000000000000000010001000000000000000100101100100101101100010000000000100100101
1000000100001000011000000000000001010000001010000000000000000001001000000100011000101000000000001001
1100001000000000000000100000101000000000000001110001000000001000010001000000000100000010100000100011
1100010010001100010000100100100000000101000000010000000001101001010001000010010101110100100000001001
1000100000011000000101000000000101011000001000101110011000110010000000000010000000000010000000000011
1000000000100101000000001000000000100100010011000000001001000100001100000000110000000100100010000001
1000000000000000000010001000010110100000010001000000000001001101000010000101000101100000010000000011
1000000000000000000000010000000000000000100000001110000100000010000000111110000000001000000000000001
1001000000000000000000000000000000010001001110000000000010000100001000000000100000011000100001001001
1001001000001001000100011100110001010000001010011010010000000000000011000000000001000000100001000001
1110000001000010000000100100100100000100000000000001011011010000010000000000000011001000000000000101
1100100010000001100010100000000010011000000000000000000110010100000100010000010000100001010000000001
1000001000100000000000000000000000000101001010100000100010000000000001000100100001000000010010101001
1000000001000010100001010000000001000100010000000100000010000000010100000011000000000000011100101101
1001011100000000000000100100100000000101000000000001100001000000111000010110000000001100111100000101
1001010000100100010010000001001010100001000010000000010000100100000000000000000010000010000000001001
1000110000001010001001000000100000000001110100000001010010001000000000010100000100000000001000000001
1000000001000000001000000000110000000000010001000000100010010001100000000000010001000010100001000001
1100011110000000000000000100001101001000011000100011110000000000011000000010010101111010000011101001
1000000000000001100011001000001100000000000001000101010000010000100000100000000000000000010000000001
1000000010000011100100000100000001000000001100010010001000000100010001111000001010000011110001010101
1000000100000000101111100011000001001000000000101100000000000010100110000100000000011100000010010001
1100100000000000010100010001010000000100111100010010100001000010000000000000000000000010000000000101
1000000000001111010000010001010000000011010001000000011000000010001000001010110000000000010110001001
1000000000100100001000000000100000010000010010100010000000011000011000000000000000010110000100100101
1010010000000000000000010010000011001000101000100000101001000010000010100000101000010110100000000101
1001000000000000011000100010001000011000010100000000000001000100000100000001000000100000001001000101
1000000100010010100000000100000100010001100001000000011000001000000000000000000000000001010100000001
1100001101100000000000000001000000000000000000010000100000101000000000000001011000000000001000000101
1011001000001000000010000000000010000000000110000000000010000011010000001000000000000110010100110001
1000000001011100000000011010001000010000001000100100010000010001000100000011100100000001000000000001
1000100000010010000010000010101100011100100001000001000000011001110100001010000000010000000110100001
1001000000010000000000100100000000001000100000100101101000100100000000000001000110010010000100100101
1010001000000000101000000000001000000000111000001000001001100001000100000110000000000000000000010001
1100100000000011000000100001010110000100001110000100100000000000000000011010000000100000000000000001
1001000000000000000000000001000010000000000001100000000000000000000000000010000000000011000000011101
1000000000000000001000000011000001001000000110110100000010001100010000010001000000000010000001010001
1101100100000000000110000101000100000000001010000000000110010100000010000000000001001000100011000001
1000010000101001000000000000000000010000000001010001001000101001001010001000000000011000000010001001
1000100000001000000111000000100101100000001000000000000001000011000001000000100000100001001010000011
1001000010100001100001010111011011100000000100100010000000010100101000000000001010010000000100000101
1000001001010010000010000100110000100100010000100001000000000110010000000000000000010011000000100001
1000000010000010010000010110000101010110000000000000011000001000100000000110000100111001000010000001
1110100001011011000000000001110011000000000000000010000000000000000000001010100001100000000110001011
1000000000000000000010010000001000000100010000001100001100000010000000010110000000000001010110010101
1010100000010100010010101000000000010001011010010010000001010000100001001000101011010010100010010001
1010110100010100000000100010000000000000100001000000000000000000110000000000000000111001000011000101
1000000000100000000000000010101010000010000100100001100100000000010101010000000000000000000100000001
1010010001000010100001000101111000000011000000100010100001100000000010000110111000000100001011000101
1010010000001011000100000101000000100010000010000100000000000000000010000000010010000010000000001001
1100000000000110001001000010000001100000100000100010000110000100100000001000000100000000000000000011
1000100000000001110000110100000000001010001000000011000000001110000010001000000010101000001000010001
1001000100000000000101000100000010000111000100000000010001100001001000000000000000000000100100101001
1001001010000100100100100000000000000000110010001000000000010000000100000000010000000000000001000001
1111111111111111111111111111111111111111111111111111111111111111111111111111111111111111111111111111