1111111111111111111111111111
1000010000000000000000000001
1000100100000000000000000001
1000000100000000001100000001
1000100100000000001100000001
1001100100000000000000000001
110000N100000000000000000001
1111111111111111111111111111