  NO ./textures/semi_crafted_stone_wall.xpm
SO ./textures/league_wall.xpm
WE ./textures/dirt_stone.xpm
EA ./textures/stone_wall.xpm

F 0,0,0
C 0	      ,     255, 0    

     1111111111111111111111111111
     1S00010000000000000000000111
1111110100001000000000000001111
1000000100000000001100000001
1000100110000000001100000001
1001100100000000000000010001
1100000100000010000000000001
1001100100000111000000000001
1100000000000000001000000011
1001100100000111001100000001
11000001000001 1001000000001
11111111111111 11111111111111