1111111111111111111111111111
1000010000000000000000000001
1000100100001000000000000001
1000000100000000001100000001
1000100110000000001100000001
1001100100000000000000010001
1100000100000010000000000001
1001100100000111000000000001
1100000000000000001000000011
1001100100000000001100000001
1100000100000000001000000001
1111111111111111111111111111