NO ./textures/soil_with_grass256x256.xpm
SO ./textures/soil_with_grass256x256.xpm
WE ./textures/soil_with_grass256x256.xpm
EA ./textures/soil_with_grass256x256.xpm

F 0,0,0
C 0	      ,     255, 0    






     1111111111111111111111111111
     1S00010000000000000000000111
1111110100001000000000000001111
1000000100000000001100000001
1000100110000000001100000001
1001100100000011100000010001
110000010000001 100000000001
1001100100000111100000000001
1100000000000000001000000011
1001100100000111001100000001
11000001000001 1001000000001
11111111111111 11111111111111