  NO ./textures/semi_crafted_stone_wall.xpm
SO ./textures/league_wall.xpm
WE ./textures/dirt_stone.xpm
EA ./textures/stone_wall.xpm
F 220,100,0
C 225	      ,     30, 19    

        1111111111111111111111111
        1000100001100000000000001
        1011000000111000000000001
        1001000000000000000000001
111111111011000001110000000000001          111111
100000001011000001110111111111111          100001
11110111111111011100000010001              100001
11110111111111011101010010001              111111
11000000110101011100000010001
10000000000000001100000010001
10000000000000001101010010001
11000001110101011111011110N0111
11110111 1110101 101111010001
11111111 1111111 111111111111
 
     
1111111111111111111111111
1000100001100000000000001
1011000000111000000000001
1001000000000000000000001
1111111111111111111111111
