  NO ./textures/semi_crafted_stone_wall.xpm
SO ./textures/league_wall.xpm
WE ./textures/dirt_stone.xpm
EA ./textures/stone_wall.xpm

F 255,128,0
C 0	      ,     255, 0    

	    1111111111111111111111111
        1W00100001100000000000001
        1011000000111000000000001
	    1001000000000000000000001
111111111011000001110000000000001
100000001011000001110111111111111
11110111111111011100000010001
11110111111111011101010010001
11000000110101011100000010001
10000000000000001100000010001
10000000000000001101010010001
1100000111010101111101111000111
11110111 1110101 101111010001
11111111 1111111 111111111111
