  NO ./textures/semi_crafted_stone_wall.xpm
SO ./textures/league_wall.xpm
WE ./textures/dirt_stone.xpm
EA ./textures/stone_wall.xpm

F 0,0,0
C 0	      ,     255, 0         

11111
10001
10001
10W01
11111
