11111111
10000101
10001001
10000001
10000001
10000001
110000N1
11111111