 NO ./textures/semi_crafted_stone_wall.xpm
SO ./textures/league_wall.xpm
WE ./textures/dirt_stone.xpm
EA ./textures/stone_wall.xpm

F 220,100,0
C 225	      ,     30, 19    

11111111
10000101
10001001
10000001
10001001
10011001
110000N1
11111111
