 NO ./textures/semi_crafted_stone_wall.xpm
SO ./textures/league_wall.xpm
WE ./textures/dirt_stone.xpm
EA ./textures/stone_wall.xpm

F 220,100,0
C 225	      ,     30, 19    

1111
1001
1001
1111
